XXXXXXXX
XOXOOOOX
XOXOOOOX
XOXOOOOX
XOOOOOOX
XOOOOXOX
XOOOOOOX
XXXXXXXX
